1111111111111111111111111111111111111111111111111111111
1111111111111111111111111111111111111111111111111111111
11111CCCC111CCCCCCC11CCCCC1111CCCC111CC1111C1C111C11111
1111C1111111111C11111C111C111C1111C11C1C111C1C11C111111
11111CCC1111111C11111CCCC111C111111C1C11C11C1CCC1111111
11111111C111111C11111CCC1111C111111C1C111C1C1CCC1111111
111111111C11111C11111C11C1111C1111C11C1111CC1C11C111111
11111CCCC111111C11111C111C1111CCCC111C11111C1C111C11111
1111111111111111111111111111111111111111111111111111111
1111111111111111111111111111111111111111111111111111111
1111111111111111111111111111111111111111111111111111111
111P0110000C0N0000000N00C000100010111C00101C00000111111
111100001001101000N11000000000C000C1000N001101010N11111
111C01000100000C01000011C00000001000000N001010100E11111
111100100000010100010000001001000C0000100000C0000001111
11101011000C0000N001000N010110100010000010010C010101111
1111111111111111111111111111111111111111111111111111111
1111111111111111111111111111111111111111111111111111111
1111111111111111111111111111111111111111111111111111111