1111111111111111111111111111111111
1001000000000000000000000000000001
10000001000000000000000C0000000001
1000000000000000000000000000000001
10001000P0000001000000010000000001
1000000000000000000000000000000001
1000000000000000000000000000000001
10000010000000100000000C0000000001
1000000000000000000000000000000001
1000100000000000000000000000000001
1000000000000C00000001000000000001
1000000000000000000000000000000001
1000000000000011000000000000000001
1000000000000000100000010010000001
1000C010000010000000000C0000000001
100100011100000N00000000000E000001
1000000000000000000000000000000001
1111111111111111111111111111111111