1111111111111111111111111111111111111111111111
11P0000000000000000000000000000000000011111111
1111111111111111111111111111111100000011111111
1111111111111100000000000000000001111111111111
1110000000000000000000111111111111111111111111
1110001111111001111111111111111111111111111111
1111110000011111111111111111111111111111111111
1111111111000001111111111111111111111111111111
1111111111N11101111111111111111111111111111111
1111111111111100111111111111111111111111111111
100000000000000000000000000000000C00000000E001
1111111111111111111111111111111111111111111111